#######################
#**********#**********#
#*###*####*#*####*###*#
#*###*####*#*####*###*#
#*********************#
#*###*#*#######*#*###*#
#*****#*#######*#*****#
#####*#****#****#*#####
    #*#### # ####*#    
    #*#         #*#    
#####*# ### ### #*#####
     *  #BI PC#  *     
#####*# ####### #*#####
    #*#    @    #*#    
    #*# ####### #*#    
#####*# ####### #*#####
#**********#**********#
#*###*####*#*####*###*#
#***#****** ******#***#
###*#*#*#######*#*#*###
#*****#****#****#*****#
#*########*#*########*#
#*########*#*########*#
#*********************#
#######################