#####################
#*****#*******#*****#
#&###*#*#####*#*###&#
#*******************#
###*#*###*#*###*#*###
###*#*###*#*###*#*###
   *#*****#*****#*   
###*### ##### ###*###
  #*             *#  
  #*### ##b## ###*#  
  #*#   #ipc#   #*#  
###*# # ##### # #*###
   *  #       #  *   
###*##### # #####*###
  #*****  #  *****#  
###*###*#####*###*###
#*********@*********#
#*###*###*#*###*###*#
#*###*#***#***#*###*#
#&###*#*#####*#*###&#
#*******************#
#####################  