#######################
#**********#**********#
#&###*####*#*####*###&#
#*###*####*#*####*###*#
#*********************#
#*###*#*#######*#*###*#
#*****#*#######*#*****#
#####*#****#****#*#####
    #*#### # ####*#    
    #*#         #*#    
#####*# ### ### #*#####
     *  #ib pc#  *     
#####*# ####### #*#####
    #*#         #*#    
    #*# ####### #*#    
#####*# ####### #*#####
#**********#**********#
#*###*####*#*####*###*#
#&**#******@******#**&#
###*#*#*#######*#*#*###
#*****#****#****#*****#
#*########*#*########*#
#*########*#*########*#
#*********************#
#######################