#####################
#*******************#
#*#*###*#####*###*#*#
#&#*###*#***#*###*#&#
#*#*****#*#*#*****#*#
#*###*#*#*#*#*#*###*#
#*****#***#***#*****#
###*##### # #####*###
###***#       #***###
    #*# ##b## #*#    
#####*  #ipc#  *#####
    #*# ##### #*#    
###***#       #***###
  #*#*### # ###*#*#  
  #*#*****#*****#*#
###*###*#*#*#*###*###
#*******#*@*#*******#
#*###*#*#####*#*###*#
#*#***#*******#***#*#
#&#*#####*#*#####*#&#
#*********#*********#
#####################